_______________S_____________X____
XX_XXX_XXXXXXXXXXXXXXXXXXXXXXX__X_
___X_X_X_______________________XX_
_X_X_____XXX_XX_XXXXXX_XXXXXXXX_X_
___X_X_X_X____X_X__XGX____XXX___X_
_X_XXX_XXX_XX_X_X_XXXX_XX_XX__XXX_
XX_____XXX_____________XXXXX______